git config --global user.name 'alexeypato' - задаем имя пользователя
git config --global user.email alexeypato@gmail.com - задаем email пользователя
git add 1.txt - добавляем файл в подготовленные, для дальнейшей фиксации
git add . - добавляем все файлы в подготовленные, для дальнейшей фиксации
git commit -m 'My Commit' - добавление подготовленных файлов в Commit
git commit -a -m 'my last commit' - добавление в Commit сразу всех файлов(и подготовленных, и неподготовленных)
git config --list - просмотр текущих настроек GIT
git init - создание пустой директории в папке
git status - отображает статус всех документов в рабочей директории
git log - просмотр Commit
git log -p - развернутый просмотр Commit(q - выход из просмотрщика)
git checkout 292e7619 - откат к заданному Commitu
git checkout master - откат к последнему Commitu
git checkout new1.txt - откат к последнему Commitu файла new1.txt
git diff - просмотр изменений в файле
git diff --cached (--staged) - просмотр изменений в подготовленном файле
git reset HEAD new1.txt - переместить файл в неподготовленные
git log --graph - отображает Commit графами

git branch -a - отображает все ветки
git branch bugFix - создание новой ветки bagFix
git checkout bagFix - переключение на другую ветку
git checkout -b hotFix - создание и сразу переключение на ветку hotFix
git branch -d hotFix - удаление ветки hotFix
git merge bugFix - слияние веток

git remote - просмотр удаленных репозиториев
git remote add site https://github.com... - добавление URL удаленного репозитория
git push -u site master - выгрузка на удаленный репозиторий ветки master
git clone https://github.com... - загрузка всего из удаленного репозитория
git fetch site - снимает всю информацию с удаленного репозитория но не загружает ее
git pull origin master - снятие и слияние информации с удаленного репозитория